%%map
%metadata
type:map
subtype:outdoor
name:test_map_world
label:World Map
width:60
height:36
startingX:3
startingY:4


%terrain_codes
1:mountains
2:hills_2
3:hills_1
4:plains_2
5:plains_1

%tile_list
# format: 
# x -->
# y 
# |
# v
1|1|1|1|1|1|1|1|1|1|1|1|1|1|1|1|1|1|1|1|1|1|1|2|2|2|2|2|2|2|2|2|2|2|2|2|2|2|2|2|2|2|1|1|1|1|1|1|1|1|1|1|1|1|1|1|1|1|1|1
1|1|1|1|1|1|1|1|1|1|1|1|1|1|1|1|1|1|1|1|1|2|2|2|2|2|2|2|2|2|2|2|3|3|3|2|2|2|2|2|2|2|2|1|1|1|1|1|1|1|1|1|1|1|1|1|1|1|1|1
1|1|1|1|1|1|1|1|1|1|1|1|1|1|1|1|1|1|1|1|2|2|2|2|2|2|2|2|2|2|3|3|3|3|2|2|2|2|2|2|2|2|2|2|1|1|1|1|1|1|1|1|1|1|1|1|1|1|1|1
1|1|1|1|1|1|1|1|1|1|1|1|1|1|1|1|1|1|2|2|2|2|2|2|2|2|2|2|2|2|2|2|3|3|3|3|2|2|2|2|2|2|2|2|1|1|1|1|1|1|1|1|1|1|1|1|1|1|1|1
1|1|1|1|1|1|1|1|1|1|1|1|1|1|1|1|1|1|2|2|2|2|2|2|2|2|2|2|2|2|2|2|3|3|3|2|2|2|2|2|2|2|2|2|2|1|1|1|1|1|1|1|1|1|1|1|1|1|1|1
1|1|1|1|1|1|1|1|1|1|1|1|1|1|1|1|2|2|2|2|2|2|2|2|2|2|3|3|2|2|2|2|2|2|2|2|2|2|2|3|2|2|2|2|2|1|1|1|1|1|1|1|1|1|1|1|1|1|1|1
1|1|1|1|1|1|1|1|1|1|1|1|1|1|2|2|2|2|2|2|2|2|2|2|2|3|3|3|3|2|2|2|2|2|2|2|2|2|3|3|3|3|2|2|2|2|1|1|1|1|1|1|1|1|1|1|1|1|1|1
1|1|1|1|1|1|1|1|1|1|1|1|1|2|2|2|2|2|2|2|2|2|2|3|3|3|3|3|3|3|3|2|2|2|2|2|3|3|3|3|3|3|3|3|2|2|2|2|2|2|2|1|1|1|1|1|1|1|1|1
1|1|1|1|1|1|1|1|1|1|2|2|2|2|2|2|2|2|3|3|3|3|3|3|3|3|3|3|3|3|2|2|3|3|3|3|3|3|3|3|3|2|2|2|2|2|2|2|2|2|2|2|2|2|1|1|1|1|1|1
1|1|1|1|1|1|1|1|2|2|2|2|2|2|2|2|2|2|2|2|3|3|3|3|3|3|4|4|3|3|3|3|3|3|3|3|3|3|3|3|3|3|3|3|2|2|2|2|2|2|2|2|2|2|2|2|1|1|1|1
1|1|1|1|1|1|2|2|2|2|2|2|2|2|2|3|3|3|3|3|3|3|3|3|3|4|4|4|3|3|3|3|3|3|3|3|2|3|3|3|3|3|3|3|3|3|3|2|2|2|2|2|2|2|2|2|2|2|2|1
1|1|2|2|2|2|2|2|2|2|2|2|2|2|2|3|3|3|3|3|3|4|3|3|3|4|4|4|3|3|3|3|3|3|3|3|2|3|3|3|3|3|3|3|3|3|3|3|3|3|2|2|2|2|2|2|2|2|2|2
2|2|2|2|2|2|2|2|2|2|2|2|2|3|3|3|3|3|3|3|4|4|4|4|4|4|5|4|4|3|3|3|3|3|3|2|2|3|3|3|3|3|3|3|3|3|3|4|3|3|3|3|3|2|2|2|2|2|2|2
2|2|2|2|2|2|2|2|2|2|2|3|3|3|3|3|3|3|3|3|3|4|4|4|4|5|5|4|4|4|3|3|3|3|3|2|2|3|3|3|3|3|3|3|3|3|3|4|4|3|3|3|3|3|3|3|2|2|2|2
2|2|2|3|3|3|3|3|3|3|3|3|3|3|3|3|3|3|3|3|4|4|4|4|5|5|5|4|4|4|3|3|3|3|3|3|3|3|3|3|3|3|3|3|3|3|4|4|4|4|4|4|4|4|3|3|3|2|2|2
2|2|2|2|3|3|3|3|3|3|2|2|3|3|3|3|3|3|3|3|3|4|4|4|4|4|4|4|3|3|3|3|3|3|3|3|3|3|4|4|4|4|4|4|4|4|4|4|4|4|4|4|3|3|3|3|3|3|2|2
2|2|2|2|2|2|3|3|3|2|2|2|2|2|2|2|3|3|3|3|3|3|3|3|3|4|4|3|3|3|3|3|3|3|3|3|3|3|3|3|4|4|4|4|4|4|4|4|5|5|4|4|4|4|4|4|3|3|3|3
2|2|2|2|2|3|3|3|3|2|2|2|2|2|2|2|2|2|2|2|2|2|2|2|2|3|3|3|3|3|3|3|3|3|3|3|3|4|4|4|4|4|4|4|4|5|5|5|5|5|5|4|4|4|3|3|3|3|3|3
2|2|2|2|3|3|2|3|3|2|3|3|2|2|2|2|2|2|2|2|2|2|2|2|2|2|3|3|3|3|3|3|3|3|3|3|3|3|4|4|4|4|4|4|4|4|5|5|5|5|5|5|4|4|3|3|3|2|2|2
2|2|2|2|3|3|2|2|3|3|3|3|2|2|2|2|2|2|2|2|2|2|2|2|2|2|2|2|3|3|3|3|3|3|3|3|3|4|4|4|4|4|4|5|5|5|5|5|5|4|4|4|4|3|3|3|3|3|2|2
2|2|2|2|3|3|3|3|3|3|3|2|2|2|2|2|2|2|2|2|2|2|2|2|2|2|2|2|2|3|3|3|3|3|3|4|4|4|4|4|4|4|4|5|5|5|5|5|5|4|4|4|4|4|4|3|3|2|2|2
2|2|2|2|2|3|3|3|3|2|2|2|2|2|2|2|2|2|2|2|2|1|1|2|2|2|2|2|2|2|2|3|3|3|3|3|3|4|4|4|4|4|4|5|5|5|5|5|5|4|4|4|4|3|3|3|3|3|2|2
2|2|2|2|2|3|3|2|2|2|2|2|2|2|2|2|2|2|2|1|1|1|1|1|2|2|2|2|2|2|3|3|3|3|3|3|4|4|4|4|4|4|4|5|5|5|5|5|4|4|4|4|4|4|3|3|2|2|2|2
2|2|2|2|3|3|3|2|2|2|2|2|2|2|2|2|2|1|1|1|1|1|1|1|1|1|2|2|2|2|2|3|3|3|3|3|3|3|3|4|4|4|4|5|5|5|5|4|4|4|4|4|3|3|3|2|2|2|2|2
2|2|2|2|2|3|3|3|3|2|2|2|2|2|2|2|1|1|1|1|1|1|1|1|1|1|2|2|2|2|2|2|3|3|3|3|3|3|4|4|4|4|4|4|5|4|4|4|3|3|3|3|3|2|2|2|2|2|2|2
2|2|2|2|2|2|2|2|2|2|2|2|2|2|2|2|1|1|1|1|1|1|1|1|1|1|2|2|2|2|3|3|3|3|3|3|3|3|3|3|4|4|4|4|4|4|3|3|3|3|2|2|2|2|2|2|2|2|2|2
2|2|2|2|2|2|2|2|2|2|2|2|2|2|2|2|1|1|1|1|1|1|1|1|1|2|2|2|2|3|3|3|3|3|3|3|3|3|3|3|3|3|3|3|3|3|3|2|2|2|2|2|2|2|2|2|2|2|2|2
2|2|2|2|2|2|2|2|2|2|2|2|2|2|2|2|2|2|1|1|1|2|2|2|2|2|2|2|2|2|2|2|2|2|2|3|3|3|3|3|2|2|2|2|2|2|2|2|2|2|2|2|2|2|2|2|2|2|2|2
2|2|2|2|2|2|2|2|2|2|2|2|2|2|2|2|2|2|1|2|2|2|2|2|2|2|2|2|2|2|2|2|2|2|2|3|3|3|3|3|2|2|2|2|2|2|2|2|2|2|2|2|3|2|2|2|3|3|3|2
2|2|2|2|2|2|2|2|2|2|2|2|2|2|2|2|2|2|2|2|2|2|2|2|2|2|2|2|2|2|2|2|2|2|3|3|3|3|3|3|3|2|2|2|2|2|2|2|2|2|2|3|3|3|3|3|3|3|3|2
2|2|2|2|2|2|2|2|2|2|3|3|3|3|2|2|2|2|2|2|2|2|2|2|2|2|2|2|2|2|2|2|2|2|2|3|3|3|2|3|3|3|3|3|3|3|2|2|3|2|3|3|4|4|3|3|3|2|2|2
2|2|2|2|2|2|2|2|2|2|3|3|3|3|3|2|2|2|2|2|2|2|2|2|2|2|2|2|2|2|3|3|3|3|3|3|3|3|2|3|3|3|3|3|3|3|3|3|3|3|3|3|4|4|3|3|2|2|2|2
2|2|2|2|2|2|2|2|3|3|3|3|3|3|2|2|2|2|2|2|2|2|2|2|2|2|2|2|2|3|3|3|3|3|3|3|2|2|2|2|2|2|3|2|2|3|3|3|3|3|3|3|4|3|3|3|3|2|2|2
2|2|2|2|2|2|3|3|3|3|3|3|3|3|3|3|3|3|2|2|2|2|2|2|2|2|2|2|2|2|2|3|3|3|3|3|3|3|2|2|2|2|2|2|2|2|2|2|2|3|3|3|3|3|2|3|2|2|2|2
2|2|2|3|3|3|3|3|3|4|4|4|4|4|4|3|3|3|3|3|3|2|2|2|2|2|2|2|2|2|2|2|2|2|3|3|3|2|2|2|2|2|2|2|2|2|2|2|2|2|2|2|2|2|2|2|2|2|2|2
2|2|3|3|3|3|4|4|4|4|4|4|4|4|4|4|4|4|3|3|3|3|2|2|2|2|2|2|2|2|2|2|2|3|3|3|3|2|2|2|2|2|2|2|2|2|2|2|2|2|2|2|2|2|2|2|2|2|2|2



%item_list

%site_list
#format: 
#name|pos_x|pos_y|[char]|[color]|[darkColor]|[map]
Milano|4|6|+|blue|darkblue|test_map_milano
Bergamo|14|16|+|blue|darkblue|test_map_milano
Brescia|9|26|+|blue|darkblue|test_map_milano
Lodi|20|6|+|blue|darkblue|test_map_milano
Varese|22|12|*|blue|darkblue|test_map_milano
Como|30|28|+|blue|darkblue|test_map_milano
Sondrio|42|38|+|blue|darkblue|test_map_milano
Cremona|45|18|*|blue|darkblue|test_map_milano
Crema|51|16|+|blue|darkblue|test_map_milano
Pavia|52|9|+|blue|darkblue|test_map_milano
Prato|40|13|*|blue|darkblue|test_map_milano
Lucca|20|24|+|blue|darkblue|test_map_milano

%actor_list
#format: 
#name|pos_x|pos_y
orc|10|10
orc|10|12
orc|10|8
troll|12|14

%item_list


%%map
%metadata
type:map
subtype:outdoor
name:test_map_world2
label:Test World Map2
width:4
height:4

%terrain_codes
1:mountains
2:hills_2
3:hills_1
4:plains_2
5:plains_1

%tile_list
# format: 
# x -->
# y 
# |
# v
4|4|4|4
4|3|3|4
4|3|3|4
4|4|4|4


%site_list
#format: 
#name|pos_x|pos_y|[char]|[color]|[darkColor]|[map]

%actor_list
#format: 
#name|pos_x|pos_y

%item_list

